#####################################
#  K  #  K  #  K  #  K  #  K  #     #
#S    D  R  D  R  D  R  D  R  D  R  #
#  K  #  K  #  K  #  K  #  K  #     #
#####################################