#######################
#            # K     R#
#     K      #        #
#            #        #
#            D        #
#S           #      K #
#            #        #
#         K  #        #
##################D####
#            #        #
#            D        #
#            #        #
#            #R       #
# R          # K     K#
#######################