###############
# K  # R      #
#    #     K  #
#    #        #
#S   D        #
##########D####
#R     D      #
#      #      #
#     K#      #
#      #R K   #
###D###########
#             #
#       #     #
#       #R    #
###############