#################################################################
#         K    #       R#       #K          D           #R      #
#              #        D       #           #        R  #       #
#              #        #       D        R  #           #       #
#              #        #   K   #           #           #       #
#S             D     K  #   R   #           #   K       D       #
#################################################################