##############
#           R#
#            #
#            #
#            #
#S           #
##############