#############################################
#                        #                  #
#                        #                  #
#                        #                  #
#                                           #
#                        #                  #
#                        #     R            #
#                        ####################
#                        #                  #
#                        #                  #
############D#############                 K#
#                                           #
#                                           #
#                                           #
#                                           #
#S                                          #
#############################################