#######################
#                     #
#                     #
#                     #
#                     #
#               R     #
#                     #
#                     #
#                     #
#                     #
#                     #
#                     #
#                     #
#                     #
#                     #
#                     #
#                     #
#                     #
#                     #
#                     #
#S                    #
#######################