#############################################
##########################                  #
##########################                  #
##########################             R    #
##########################                  #
##########################                  #
##########################                  #
##########################                  #
##########################                  #
##########################                  #
##########################                  #
#                                           #
#                                           #
#                                           #
#                                           #
#                                           #
#S                    #######################
#                                           #
#                                           #
#                                           #
#                                           #
#                                           #
##########################                  #
##########################                  #
##########################                  #
##########################                  #
##########################                  #
##########################                  #
##########################             R    #
##########################                  #
##########################                  #
#############################################